four	4
for	4
location	20
Mom	303
information	411
minutes	MINS
Starbucks	*$
heart	<3
love	<3
wonder	1-D-R
wonderful	1daful
Today	2day
Tomorrow	2moro
tonight	2nite
Forever	4e
Forever	4eva
Forever	4ever
Foreigner	4NR
sex	53X
it	8t
about	ab/abt
Address	add
address	addy
address	ADR
advised	ADVD
be	B
because	B/C
between	B/W
before	B4
because	BC
because	bcoz
Nudge	beos
Blackberry	Blkbry
Better	BTR
bye	buhbye
busy	BZ
see	C
program	C
city	C-T
can	CN
security	CQRT
couple	CUPL
because	CUZ
cancelled	CX
disconnected	d/c
dude	d00d
date	D8
there	da
Definitely	def
them	dem
these	dese
dude	dewd
they	dey
doing	doin
everyone	every1
easy	EZ
Friend	F
Follow-Up	F/U
Face-to-Face	F2F
Free-To-Talk	F2T
Favorite	FAV
Friends-Forever	FF
Free-For-All	FFA
Forget-about-it	FGDAI
Father-In-Law	FIL
First-lady	FLOTUS
Friend-of-a-friend	FOAF
freezing	FRZN
for-sale	FS
football	FTBL
Forget-about-it	Fuhgedabouit
forward	FWD
guess	G
grin	G
giggle	G
god	G+od
good-one	G1
got-to-go	G2G
go-for-it	G4I
good-for-nothing	G4N
genius	G9
good-night	g98t
go-ahead	GA
good-afternoon	GA
get-a-life	GAL
God	gawd
God-damn-it	GDI
girlfriend	GF
google-it	GI
goodluck	GL
get-lost	GL
good-night	GN
good-night	gn8
great	GR8
conguratulations	gratz
girls	grrlz
growling	GRRR
got-to-go	GTG
got-to-go-bye	GTGB
government	gumint
government	guvment
government	guvmint
hold-on	h/o
hold-please	h/p
hugs-and-kisses	H&K
hacker	H4XX0R
hate	h8
laughing	hahaha
hugs-and-kisses	HAK
how-are-you	HAY
hurry-back	HB
hold	HD
High-five	Hi5
hang-on	HO
hold-on	HO
how-are-you	howru
hook-up	HU
hugs	HUGZ
what	huh
have	HV
history	hx
hospital	hx
ideal	I-D-L
identification	ID
jealous	Jealz
OK	K
over	KKK
knock	KOK
laugh	L
later	L8R
Last-In-First-Out	LIFO
hello	lo
loser	luser
love	luv
mom	M
mate	M8
mates	M8s
yeah	mhhm
mobile	mob 
message	MSG
No	N
And	N
Naturally	natch
Indian	NDN
Any	ne
anyways	ne-wayz
Anyone	ne1
Enemy	NME
noone	no1
Energy	NRG
nothing	nth
nonetheless	NTL
newbie	NUB
Enough	NUFF
of course	ofc
okay	OK
all correct	OK
over	ova
Australia	OZ
Partner	P
Pizza	P-ZA
person	P3r50n
Passengers	PAX
people	peeps
pictures 	pix
photos	pix
Please	PLS
Please	PLZ
post-modern	po-mo
computer	puter
password	pw
own	pwn
owned	pwnt
quick	qixit
Reply	QLS
Cutie	QT
quite	QT
are	r
Reservation	RESO
regards	rgds
Roger	RGR
Remake	RM
rainy	RNY
Regards	RX
Smile	S
quiet	shhh
skater	sk8er
skater	sk8r
Skincare	Sknkr
something	smt
sunny	SNNY
someone	some1
Sorry	soz
speak	spk
seriously	srsly
sorry	sry
something	sth
Straight	STR8
sucks	sux
sweetheart	sweet<3
Traffic	TFX
Thanks	THX
Thanks	Tx
Thanks	THK
Thanks	TNX
www	tripdub
tornado	TRNDO
TRUE	troo
Twitter	TWTR
Thanks	TXS
Text	TXT
You	u
yours	Urs
yours	URZ
your	ur
Very	V
What?	W@
With	W/
Weekend	W/E
Without	W/O
Wait	W8
wicked	wckd
world	wirld
week	wk
weekend	wknd
windy	WNDY
warm	WRM
was	wuz
Weather	WX
women	wymyn
Exciting	X-I-10
Excellent	XLNT
Exquisite	XQZT 
Ecstasy	XTC
Yes	Y
Why	Y 
wife	YF